R  640 400
NO /home/visv/42/code/cub3d/res/textures/no.xpm
SO /home/visv/42/code/cub3d/res/textures/so.xpm
WE /home/visv/42/code/cub3d/res/textures/we.xpm
EA /home/visv/42/code/cub3d/res/textures/ea.xpm
S /home/visv/42/code/cub3d/res/textures/ea.xpm
F 255,128,64
C 64,128,255

          11111111111111111111111111
111111111110000000000000000000000021
100000000000000000000000000000000011
100000000000000000000000000000000011111
1000000000000000000000000000000000000011
10E000000000000000000000000000000011111111                               1111111111111
10000000000000000000000011111100000000000111                             1000000000001
1000000000000000000000001    100000000001111111111111111111111111111111111100000000001
1000000000000000000000001    100000000000000000000000000000000000000000000000000000001
1000000000000000000000001    100000000000000000000000000000000000000000000000000000001
1000011100000000000000001    100000000001111111111111110000011111111111111100000000001
1000011100000000000000001    1000000000000011         1000001             100000000001
111111 10000000000000000111111100000000000111         1000001             100000000001
1111111100000000000000000000000000011111111           1000001             111100001111
1000000000100010001000100000000000011111111111111111111000001111111111111111110000111
10000000001000100100010000000000000000000000000000000000000000000000000000000000001
11111000111111101001111111111111111000000000000000000000000000000000000000000000001
    10001     111111              1111111111111111111111111111111111111111111111111
    11111
